.................XXXXXXXX..........................................
....................XXXXXXXXX.......XXXXXXXX.......................
.................XXXXXXXX..............XXX...XXXXX.................
.....................XXXXXX.....X...XXXXXXXXXXX....................
................................X..................................
......XXXXXXXXXXXXX.............X..................................
..................X.............XXXXXXXXX..........................
..................X.........XXXXXXXXXXXX...........................
..................X................................................
XX.............................................................XXXX
XX..................XXXXXXXXXXXXX.................................X
...................................................................
.................................................................X.
.....................XXXXX.......................................X.
