...................................................................
...X........X.....XXXXX......XXXXXXX...XXXXXXXXXX..XXXXXXXXXX......
...XX......XX....XX...XX....XX.....XX.....XXXX.....XXXXXXXXXX......
...XXXX..XXXX...XX.....XX...XX.....XX......XX......XX..............
...XX.XXXX.XX...XX.....XX...XX.....XX......XX......XX..............
...XX...X..XX...XX.....XX...XXXXXXXX.......XX......XXXXX...........
...XX......XX...XXXXXXXXX...XXXX...........XX......XXXXX...........
...XX......XX..XX.......XX..XX.XX..........XX......XX..............
...XX......XX..XX.......XX..XX...X.........XX......XX..............
...XX......XX..XX.......XX..XX....X......XXXXXX....XXXXXXXXXX......
...XX......XX.XX.........XX.XX.....XX..XXXXXXXXXX..XXXXXXXXXX..X...
..................................................................X
